"filename", "language", "java", "comment", "blank", "total"
"/home/admin/joseph/Misc/Other/Distributed-Automation-2/DA2/src/com/jtelaa/da2/bot/lib/BotPlugin.java", "java", 4, 0, 4, 8
"/home/admin/joseph/Misc/Other/Distributed-Automation-2/DA2/src/com/jtelaa/da2/bot/main/Main.java", "java", 3, 0, 2, 5
"/home/admin/joseph/Misc/Other/Distributed-Automation-2/DA2/src/com/jtelaa/da2/bot/plugin/bw/BingRewards.java", "java", 3, 0, 3, 6
"/home/admin/joseph/Misc/Other/Distributed-Automation-2/DA2/src/com/jtelaa/da2/bot/plugin/bw/util/Query.java", "java", 3, 0, 3, 6
"/home/admin/joseph/Misc/Other/Distributed-Automation-2/DA2/src/com/jtelaa/da2/director/Main.java", "java", 8, 0, 6, 14
"/home/admin/joseph/Misc/Other/Distributed-Automation-2/DA2/src/com/jtelaa/da2/director/util/cli/CLI.java", "java", 20, 4, 13, 37
"/home/admin/joseph/Misc/Other/Distributed-Automation-2/DA2/src/com/jtelaa/da2/director/util/cli/clis/BotCLI.java", "java", 6, 0, 6, 12
"/home/admin/joseph/Misc/Other/Distributed-Automation-2/DA2/src/com/jtelaa/da2/director/util/cli/clis/DirecCLI.java", "java", 6, 0, 7, 13
"/home/admin/joseph/Misc/Other/Distributed-Automation-2/DA2/src/com/jtelaa/da2/director/util/cli/clis/HypervisCLI.java", "java", 6, 0, 6, 12
"/home/admin/joseph/Misc/Other/Distributed-Automation-2/DA2/src/com/jtelaa/da2/director/util/cli/clis/Misc.java", "java", 6, 0, 7, 13
"/home/admin/joseph/Misc/Other/Distributed-Automation-2/DA2/src/com/jtelaa/da2/director/util/cli/clis/SchedCLI.java", "java", 6, 0, 5, 11
"/home/admin/joseph/Misc/Other/Distributed-Automation-2/DA2/src/com/jtelaa/da2/director/util/config/ConfigLoader.java", "java", 3, 0, 3, 6
"/home/admin/joseph/Misc/Other/Distributed-Automation-2/DA2/src/com/jtelaa/da2/director/util/user/Login.java", "java", 2, 0, 2, 4
"/home/admin/joseph/Misc/Other/Distributed-Automation-2/DA2/src/com/jtelaa/da2/director/util/user/User.java", "java", 3, 0, 3, 6
"/home/admin/joseph/Misc/Other/Distributed-Automation-2/DA2/src/com/jtelaa/da2/director/util/user/UserHandler.java", "java", 2, 0, 2, 4
"/home/admin/joseph/Misc/Other/Distributed-Automation-2/DA2/src/com/jtelaa/da2/directorapp/Main.java", "java", 68, 0, 32, 100
"/home/admin/joseph/Misc/Other/Distributed-Automation-2/DA2/src/com/jtelaa/da2/directorapp/gui/GUI.java", "java", 5, 0, 5, 10
"/home/admin/joseph/Misc/Other/Distributed-Automation-2/DA2/src/com/jtelaa/da2/hypervisorinterface/Main.java", "java", 3, 0, 3, 6
"/home/admin/joseph/Misc/Other/Distributed-Automation-2/DA2/src/com/jtelaa/da2/hypervisorinterface/util/SSH.java", "java", 112, 2, 23, 137
"/home/admin/joseph/Misc/Other/Distributed-Automation-2/DA2/src/com/jtelaa/da2/lib/config/ConfigHandler.java", "java", 8, 0, 8, 16
"/home/admin/joseph/Misc/Other/Distributed-Automation-2/DA2/src/com/jtelaa/da2/lib/config/ConfigTools.java", "java", 10, 0, 6, 16
"/home/admin/joseph/Misc/Other/Distributed-Automation-2/DA2/src/com/jtelaa/da2/lib/misc/ComputerControl.java", "java", 20, 11, 10, 41
"/home/admin/joseph/Misc/Other/Distributed-Automation-2/DA2/src/com/jtelaa/da2/lib/misc/ConsoleColors.java", "java", 59, 8, 8, 75
"/home/admin/joseph/Misc/Other/Distributed-Automation-2/DA2/src/com/jtelaa/da2/lib/misc/Misc.java", "java", 11, 0, 5, 16
"/home/admin/joseph/Misc/Other/Distributed-Automation-2/DA2/src/com/jtelaa/da2/lib/net/OneTimeConnection.java", "java", 49, 15, 23, 87
"/home/admin/joseph/Misc/Other/Distributed-Automation-2/DA2/src/com/jtelaa/da2/lib/net/Ports.java", "java", 12, 0, 6, 18
"/home/admin/joseph/Misc/Other/Distributed-Automation-2/DA2/src/com/jtelaa/da2/lib/net/StateCodes.java", "java", 10, 0, 6, 16
"/home/admin/joseph/Misc/Other/Distributed-Automation-2/DA2/src/com/jtelaa/da2/lib/net/client/Client.java", "java", 47, 22, 28, 97
"/home/admin/joseph/Misc/Other/Distributed-Automation-2/DA2/src/com/jtelaa/da2/lib/net/server/Server.java", "java", 58, 19, 31, 108
"/home/admin/joseph/Misc/Other/Distributed-Automation-2/DA2/src/com/jtelaa/da2/scheduler/Main.java", "java", 3, 0, 3, 6
"Total", "-", 556, 81, 269, 906