"filename", "language", "Java", "Properties", "Markdown", "comment", "blank", "total"
"/Users/Joseph/Desktop/GitHub/Distributed-Automation-2/DA2/src/com/jtelaa/bwbot/README.md", "Markdown", 0, 0, 13, 0, 1, 14
"/Users/Joseph/Desktop/GitHub/Distributed-Automation-2/DA2/src/com/jtelaa/bwbot/bw/Main.java", "Java", 69, 0, 0, 39, 43, 151
"/Users/Joseph/Desktop/GitHub/Distributed-Automation-2/DA2/src/com/jtelaa/bwbot/bw/README.md", "Markdown", 0, 0, 7, 0, 0, 7
"/Users/Joseph/Desktop/GitHub/Distributed-Automation-2/DA2/src/com/jtelaa/bwbot/bw/bwconfig.properties", "Properties", 0, 5, 0, 0, 0, 5
"/Users/Joseph/Desktop/GitHub/Distributed-Automation-2/DA2/src/com/jtelaa/bwbot/bw/sys/AcctInfo.java", "Java", 92, 0, 0, 57, 57, 206
"/Users/Joseph/Desktop/GitHub/Distributed-Automation-2/DA2/src/com/jtelaa/bwbot/bw/sys/SearchSystem.java", "Java", 80, 0, 0, 72, 53, 205
"/Users/Joseph/Desktop/GitHub/Distributed-Automation-2/DA2/src/com/jtelaa/bwbot/bw/util/BWControls.java", "Java", 16, 0, 0, 24, 20, 60
"/Users/Joseph/Desktop/GitHub/Distributed-Automation-2/DA2/src/com/jtelaa/bwbot/bw/util/BWWebTags.java", "Java", 6, 0, 0, 9, 7, 22
"/Users/Joseph/Desktop/GitHub/Distributed-Automation-2/DA2/src/com/jtelaa/bwbot/bw_manager/Main.java", "Java", 23, 0, 0, 12, 12, 47
"/Users/Joseph/Desktop/GitHub/Distributed-Automation-2/DA2/src/com/jtelaa/bwbot/bw_manager/README.md", "Markdown", 0, 0, 6, 0, 0, 6
"/Users/Joseph/Desktop/GitHub/Distributed-Automation-2/DA2/src/com/jtelaa/bwbot/bw_manager/accounts/AccountGen.java", "Java", 100, 0, 0, 94, 60, 254
"/Users/Joseph/Desktop/GitHub/Distributed-Automation-2/DA2/src/com/jtelaa/bwbot/bw_manager/accounts/AccountMgr.java", "Java", 83, 0, 0, 96, 66, 245
"/Users/Joseph/Desktop/GitHub/Distributed-Automation-2/DA2/src/com/jtelaa/bwbot/bw_manager/apis.properties", "Properties", 0, 1, 0, 0, 0, 1
"/Users/Joseph/Desktop/GitHub/Distributed-Automation-2/DA2/src/com/jtelaa/bwbot/bw_manager/config.properties", "Properties", 0, 0, 0, 0, 1, 1
"/Users/Joseph/Desktop/GitHub/Distributed-Automation-2/DA2/src/com/jtelaa/bwbot/bw_manager/points/PointStats.java", "Java", 3, 0, 0, 0, 3, 6
"/Users/Joseph/Desktop/GitHub/Distributed-Automation-2/DA2/src/com/jtelaa/bwbot/bw_manager/processes/InfoRequestServer.java", "Java", 24, 0, 0, 15, 14, 53
"/Users/Joseph/Desktop/GitHub/Distributed-Automation-2/DA2/src/com/jtelaa/bwbot/bw_manager/processes/InfoResponseClient.java", "Java", 59, 0, 0, 18, 29, 106
"/Users/Joseph/Desktop/GitHub/Distributed-Automation-2/DA2/src/com/jtelaa/bwbot/bw_manager/processes/PointAnnouncementListener.java", "Java", 14, 0, 0, 7, 11, 32
"/Users/Joseph/Desktop/GitHub/Distributed-Automation-2/DA2/src/com/jtelaa/bwbot/bw_manager/processes/RedemptionQueue.java", "Java", 3, 0, 0, 0, 3, 6
"/Users/Joseph/Desktop/GitHub/Distributed-Automation-2/DA2/src/com/jtelaa/bwbot/bw_manager/processes/RedemptionRequestServer.java", "Java", 0, 0, 0, 0, 1, 1
"/Users/Joseph/Desktop/GitHub/Distributed-Automation-2/DA2/src/com/jtelaa/bwbot/bw_manager/vpn/vpn.properties", "Properties", 0, 0, 0, 0, 1, 1
"/Users/Joseph/Desktop/GitHub/Distributed-Automation-2/DA2/src/com/jtelaa/bwbot/bwlib/Account.java", "Java", 95, 0, 0, 61, 47, 203
"/Users/Joseph/Desktop/GitHub/Distributed-Automation-2/DA2/src/com/jtelaa/bwbot/bwlib/Accounts.java", "Java", 78, 0, 0, 74, 47, 199
"/Users/Joseph/Desktop/GitHub/Distributed-Automation-2/DA2/src/com/jtelaa/bwbot/bwlib/BWMessages.java", "Java", 19, 0, 0, 8, 13, 40
"/Users/Joseph/Desktop/GitHub/Distributed-Automation-2/DA2/src/com/jtelaa/bwbot/bwlib/BWPorts.java", "Java", 14, 0, 0, 18, 14, 46
"/Users/Joseph/Desktop/GitHub/Distributed-Automation-2/DA2/src/com/jtelaa/bwbot/bwlib/BWUser.java", "Java", 20, 0, 0, 19, 27, 66
"/Users/Joseph/Desktop/GitHub/Distributed-Automation-2/DA2/src/com/jtelaa/bwbot/bwlib/Card.java", "Java", 218, 0, 0, 124, 96, 438
"/Users/Joseph/Desktop/GitHub/Distributed-Automation-2/DA2/src/com/jtelaa/bwbot/bwlib/Query.java", "Java", 24, 0, 0, 26, 16, 66
"/Users/Joseph/Desktop/GitHub/Distributed-Automation-2/DA2/src/com/jtelaa/bwbot/bwlib/Request.java", "Java", 69, 0, 0, 6, 47, 122
"/Users/Joseph/Desktop/GitHub/Distributed-Automation-2/DA2/src/com/jtelaa/bwbot/querygen/Main.java", "Java", 49, 0, 0, 23, 21, 93
"/Users/Joseph/Desktop/GitHub/Distributed-Automation-2/DA2/src/com/jtelaa/bwbot/querygen/README.md", "Markdown", 0, 0, 0, 0, 1, 1
"/Users/Joseph/Desktop/GitHub/Distributed-Automation-2/DA2/src/com/jtelaa/bwbot/querygen/config.properties", "Properties", 0, 0, 0, 0, 1, 1
"/Users/Joseph/Desktop/GitHub/Distributed-Automation-2/DA2/src/com/jtelaa/bwbot/querygen/processes/QueryGenerator.java", "Java", 36, 0, 0, 33, 23, 92
"/Users/Joseph/Desktop/GitHub/Distributed-Automation-2/DA2/src/com/jtelaa/bwbot/querygen/processes/QueryServer.java", "Java", 51, 0, 0, 46, 28, 125
"/Users/Joseph/Desktop/GitHub/Distributed-Automation-2/DA2/src/com/jtelaa/bwbot/querygen/processes/RequestServer.java", "Java", 23, 0, 0, 17, 14, 54
"/Users/Joseph/Desktop/GitHub/Distributed-Automation-2/DA2/src/com/jtelaa/bwbot/querygen/searches/ManualSearches.java", "Java", 39, 0, 0, 8, 7, 54
"/Users/Joseph/Desktop/GitHub/Distributed-Automation-2/DA2/src/com/jtelaa/bwbot/querygen/searches/SearchHandler.java", "Java", 56, 0, 0, 38, 26, 120
"/Users/Joseph/Desktop/GitHub/Distributed-Automation-2/DA2/src/com/jtelaa/bwbot/querygen/util/CLI.java", "Java", 12, 0, 0, 2, 9, 23
"/Users/Joseph/Desktop/GitHub/Distributed-Automation-2/DA2/src/com/jtelaa/da2/bot/README.md", "Markdown", 0, 0, 0, 0, 1, 1
"/Users/Joseph/Desktop/GitHub/Distributed-Automation-2/DA2/src/com/jtelaa/da2/bot/main/Main.java", "Java", 44, 0, 0, 17, 21, 82
"/Users/Joseph/Desktop/GitHub/Distributed-Automation-2/DA2/src/com/jtelaa/da2/bot/main/config.properties", "Properties", 0, 8, 0, 0, 0, 8
"/Users/Joseph/Desktop/GitHub/Distributed-Automation-2/DA2/src/com/jtelaa/da2/bot/plugin/Plugins.java", "Java", 51, 0, 0, 79, 47, 177
"/Users/Joseph/Desktop/GitHub/Distributed-Automation-2/DA2/src/com/jtelaa/da2/bot/plugin/README.md", "Markdown", 0, 0, 0, 0, 1, 1
"/Users/Joseph/Desktop/GitHub/Distributed-Automation-2/DA2/src/com/jtelaa/da2/bot/util/CLI.java", "Java", 31, 0, 0, 12, 17, 60
"/Users/Joseph/Desktop/GitHub/Distributed-Automation-2/DA2/src/com/jtelaa/da2/bot/util/Heartbeat.java", "Java", 21, 0, 0, 11, 15, 47
"/Users/Joseph/Desktop/GitHub/Distributed-Automation-2/DA2/src/com/jtelaa/da2/bot/util/LogRepeater.java", "Java", 22, 0, 0, 11, 14, 47
"/Users/Joseph/Desktop/GitHub/Distributed-Automation-2/DA2/src/com/jtelaa/da2/director/CLI.java", "Java", 14, 0, 0, 8, 11, 33
"/Users/Joseph/Desktop/GitHub/Distributed-Automation-2/DA2/src/com/jtelaa/da2/director/Main.java", "Java", 34, 0, 0, 13, 17, 64
"/Users/Joseph/Desktop/GitHub/Distributed-Automation-2/DA2/src/com/jtelaa/da2/director/README.md", "Markdown", 0, 0, 0, 0, 1, 1
"/Users/Joseph/Desktop/GitHub/Distributed-Automation-2/DA2/src/com/jtelaa/da2/director/botmgmt/BotMgmt.java", "Java", 56, 0, 0, 59, 43, 158
"/Users/Joseph/Desktop/GitHub/Distributed-Automation-2/DA2/src/com/jtelaa/da2/director/botmgmt/heartbeat/HeartbeatServer.java", "Java", 88, 0, 0, 63, 61, 212
"/Users/Joseph/Desktop/GitHub/Distributed-Automation-2/DA2/src/com/jtelaa/da2/director/botmgmt/heartbeat/MultipleBeats.java", "Java", 8, 0, 0, 7, 8, 23
"/Users/Joseph/Desktop/GitHub/Distributed-Automation-2/DA2/src/com/jtelaa/da2/director/botmgmt/info/BotAnnounceServer.java", "Java", 25, 0, 0, 15, 15, 55
"/Users/Joseph/Desktop/GitHub/Distributed-Automation-2/DA2/src/com/jtelaa/da2/director/botmgmt/info/InfoRequestServer.java", "Java", 21, 0, 0, 15, 13, 49
"/Users/Joseph/Desktop/GitHub/Distributed-Automation-2/DA2/src/com/jtelaa/da2/director/botmgmt/info/InfoResponseClient.java", "Java", 58, 0, 0, 18, 31, 107
"/Users/Joseph/Desktop/GitHub/Distributed-Automation-2/DA2/src/com/jtelaa/da2/director/config.properties", "Properties", 0, 2, 0, 0, 0, 2
"/Users/Joseph/Desktop/GitHub/Distributed-Automation-2/DA2/src/com/jtelaa/da2/director/logserver/LogReceiver.java", "Java", 6, 0, 0, 6, 10, 22
"/Users/Joseph/Desktop/GitHub/Distributed-Automation-2/DA2/src/com/jtelaa/da2/director/logserver/Logger.java", "Java", 24, 0, 0, 5, 28, 57
"/Users/Joseph/Desktop/GitHub/Distributed-Automation-2/DA2/src/com/jtelaa/da2/directorapp/Main.java", "Java", 65, 0, 0, 10, 29, 104
"/Users/Joseph/Desktop/GitHub/Distributed-Automation-2/DA2/src/com/jtelaa/da2/directorapp/README.md", "Markdown", 0, 0, 0, 0, 1, 1
"/Users/Joseph/Desktop/GitHub/Distributed-Automation-2/DA2/src/com/jtelaa/da2/directorapp/config.properties", "Properties", 0, 0, 0, 0, 1, 1
"/Users/Joseph/Desktop/GitHub/Distributed-Automation-2/DA2/src/com/jtelaa/da2/directorapp/gui/GUI.java", "Java", 5, 0, 0, 2, 7, 14
"/Users/Joseph/Desktop/GitHub/Distributed-Automation-2/DA2/src/com/jtelaa/da2/hypervisor_interface/Main.java", "Java", 23, 0, 0, 12, 14, 49
"/Users/Joseph/Desktop/GitHub/Distributed-Automation-2/DA2/src/com/jtelaa/da2/hypervisor_interface/README.md", "Markdown", 0, 0, 0, 0, 1, 1
"/Users/Joseph/Desktop/GitHub/Distributed-Automation-2/DA2/src/com/jtelaa/da2/hypervisor_interface/config.properties", "Properties", 0, 0, 0, 0, 1, 1
"/Users/Joseph/Desktop/GitHub/Distributed-Automation-2/DA2/src/com/jtelaa/da2/hypervisor_interface/util/CLI.java", "Java", 12, 0, 0, 4, 8, 24
"/Users/Joseph/Desktop/GitHub/Distributed-Automation-2/DA2/src/com/jtelaa/da2/lib/README.md", "Markdown", 0, 0, 0, 0, 1, 1
"/Users/Joseph/Desktop/GitHub/Distributed-Automation-2/DA2/src/com/jtelaa/da2/lib/bot/Bot.java", "Java", 34, 0, 0, 34, 29, 97
"/Users/Joseph/Desktop/GitHub/Distributed-Automation-2/DA2/src/com/jtelaa/da2/lib/bot/MgmtMessages.java", "Java", 18, 0, 0, 14, 16, 48
"/Users/Joseph/Desktop/GitHub/Distributed-Automation-2/DA2/src/com/jtelaa/da2/lib/cli/Cases.java", "Java", 74, 0, 0, 79, 27, 180
"/Users/Joseph/Desktop/GitHub/Distributed-Automation-2/DA2/src/com/jtelaa/da2/lib/cli/LocalCLI.java", "Java", 87, 0, 0, 67, 57, 211
"/Users/Joseph/Desktop/GitHub/Distributed-Automation-2/DA2/src/com/jtelaa/da2/lib/cli/README.md", "Markdown", 0, 0, 0, 0, 1, 1
"/Users/Joseph/Desktop/GitHub/Distributed-Automation-2/DA2/src/com/jtelaa/da2/lib/config/ConfigHandler.java", "Java", 81, 0, 0, 74, 53, 208
"/Users/Joseph/Desktop/GitHub/Distributed-Automation-2/DA2/src/com/jtelaa/da2/lib/config/README.md", "Markdown", 0, 0, 0, 0, 1, 1
"/Users/Joseph/Desktop/GitHub/Distributed-Automation-2/DA2/src/com/jtelaa/da2/lib/console/ConsoleBanners.java", "Java", 19, 0, 0, 79, 27, 125
"/Users/Joseph/Desktop/GitHub/Distributed-Automation-2/DA2/src/com/jtelaa/da2/lib/console/ConsoleColors.java", "Java", 75, 0, 0, 24, 19, 118
"/Users/Joseph/Desktop/GitHub/Distributed-Automation-2/DA2/src/com/jtelaa/da2/lib/console/README.md", "Markdown", 0, 0, 0, 0, 1, 1
"/Users/Joseph/Desktop/GitHub/Distributed-Automation-2/DA2/src/com/jtelaa/da2/lib/control/Command.java", "Java", 156, 0, 0, 183, 108, 447
"/Users/Joseph/Desktop/GitHub/Distributed-Automation-2/DA2/src/com/jtelaa/da2/lib/control/ComputerControl.java", "Java", 49, 0, 0, 48, 34, 131
"/Users/Joseph/Desktop/GitHub/Distributed-Automation-2/DA2/src/com/jtelaa/da2/lib/control/Messages.java", "Java", 7, 0, 0, 10, 8, 25
"/Users/Joseph/Desktop/GitHub/Distributed-Automation-2/DA2/src/com/jtelaa/da2/lib/control/QueuedCommandReceiver.java", "Java", 43, 0, 0, 36, 28, 107
"/Users/Joseph/Desktop/GitHub/Distributed-Automation-2/DA2/src/com/jtelaa/da2/lib/control/QueuedCommandSender.java", "Java", 44, 0, 0, 12, 24, 80
"/Users/Joseph/Desktop/GitHub/Distributed-Automation-2/DA2/src/com/jtelaa/da2/lib/control/QueuedResponseReceiver.java", "Java", 28, 0, 0, 11, 19, 58
"/Users/Joseph/Desktop/GitHub/Distributed-Automation-2/DA2/src/com/jtelaa/da2/lib/control/QueuedResponseSender.java", "Java", 45, 0, 0, 11, 23, 79
"/Users/Joseph/Desktop/GitHub/Distributed-Automation-2/DA2/src/com/jtelaa/da2/lib/control/README.md", "Markdown", 0, 0, 0, 0, 1, 1
"/Users/Joseph/Desktop/GitHub/Distributed-Automation-2/DA2/src/com/jtelaa/da2/lib/crypto/EncryptionUtils.java", "Java", 104, 0, 0, 205, 57, 366
"/Users/Joseph/Desktop/GitHub/Distributed-Automation-2/DA2/src/com/jtelaa/da2/lib/crypto/README.md", "Markdown", 0, 0, 0, 0, 1, 1
"/Users/Joseph/Desktop/GitHub/Distributed-Automation-2/DA2/src/com/jtelaa/da2/lib/crypto/SystemCrypto.java", "Java", 40, 0, 0, 27, 23, 90
"/Users/Joseph/Desktop/GitHub/Distributed-Automation-2/DA2/src/com/jtelaa/da2/lib/files/FileUtil.java", "Java", 119, 0, 0, 92, 79, 290
"/Users/Joseph/Desktop/GitHub/Distributed-Automation-2/DA2/src/com/jtelaa/da2/lib/files/ObjectUtils.java", "Java", 24, 0, 0, 20, 15, 59
"/Users/Joseph/Desktop/GitHub/Distributed-Automation-2/DA2/src/com/jtelaa/da2/lib/files/README.md", "Markdown", 0, 0, 0, 0, 1, 1
"/Users/Joseph/Desktop/GitHub/Distributed-Automation-2/DA2/src/com/jtelaa/da2/lib/files/excel/ExcelFile.java", "Java", 100, 0, 0, 106, 82, 288
"/Users/Joseph/Desktop/GitHub/Distributed-Automation-2/DA2/src/com/jtelaa/da2/lib/log/Log.java", "Java", 56, 0, 0, 53, 40, 149
"/Users/Joseph/Desktop/GitHub/Distributed-Automation-2/DA2/src/com/jtelaa/da2/lib/log/LogSender.java", "Java", 22, 0, 0, 18, 16, 56
"/Users/Joseph/Desktop/GitHub/Distributed-Automation-2/DA2/src/com/jtelaa/da2/lib/log/README.md", "Markdown", 0, 0, 0, 0, 1, 1
"/Users/Joseph/Desktop/GitHub/Distributed-Automation-2/DA2/src/com/jtelaa/da2/lib/mail/Mail.java", "Java", 66, 0, 0, 59, 40, 165
"/Users/Joseph/Desktop/GitHub/Distributed-Automation-2/DA2/src/com/jtelaa/da2/lib/mail/MailSender.java", "Java", 73, 0, 0, 40, 38, 151
"/Users/Joseph/Desktop/GitHub/Distributed-Automation-2/DA2/src/com/jtelaa/da2/lib/mail/MessageGateways.java", "Java", 81, 0, 0, 37, 36, 154
"/Users/Joseph/Desktop/GitHub/Distributed-Automation-2/DA2/src/com/jtelaa/da2/lib/mail/README.md", "Markdown", 0, 0, 0, 0, 1, 1
"/Users/Joseph/Desktop/GitHub/Distributed-Automation-2/DA2/src/com/jtelaa/da2/lib/misc/MiscUtil.java", "Java", 38, 0, 0, 1, 20, 59
"/Users/Joseph/Desktop/GitHub/Distributed-Automation-2/DA2/src/com/jtelaa/da2/lib/misc/README.md", "Markdown", 0, 0, 0, 0, 1, 1
"/Users/Joseph/Desktop/GitHub/Distributed-Automation-2/DA2/src/com/jtelaa/da2/lib/net/NetTools.java", "Java", 71, 0, 0, 64, 43, 178
"/Users/Joseph/Desktop/GitHub/Distributed-Automation-2/DA2/src/com/jtelaa/da2/lib/net/OneTimeConnection.java", "Java", 49, 0, 0, 16, 24, 89
"/Users/Joseph/Desktop/GitHub/Distributed-Automation-2/DA2/src/com/jtelaa/da2/lib/net/Ports.java", "Java", 4, 0, 0, 7, 5, 16
"/Users/Joseph/Desktop/GitHub/Distributed-Automation-2/DA2/src/com/jtelaa/da2/lib/net/README.md", "Markdown", 0, 0, 0, 0, 1, 1
"/Users/Joseph/Desktop/GitHub/Distributed-Automation-2/DA2/src/com/jtelaa/da2/lib/net/StateCodes.java", "Java", 10, 0, 0, 2, 7, 19
"/Users/Joseph/Desktop/GitHub/Distributed-Automation-2/DA2/src/com/jtelaa/da2/lib/net/SysPorts.java", "Java", 16, 0, 0, 21, 15, 52
"/Users/Joseph/Desktop/GitHub/Distributed-Automation-2/DA2/src/com/jtelaa/da2/lib/net/client/Client.java", "Java", 86, 0, 0, 28, 38, 152
"/Users/Joseph/Desktop/GitHub/Distributed-Automation-2/DA2/src/com/jtelaa/da2/lib/net/client/ClientUDP.java", "Java", 98, 0, 0, 85, 54, 237
"/Users/Joseph/Desktop/GitHub/Distributed-Automation-2/DA2/src/com/jtelaa/da2/lib/net/server/Server.java", "Java", 78, 0, 0, 25, 41, 144
"/Users/Joseph/Desktop/GitHub/Distributed-Automation-2/DA2/src/com/jtelaa/da2/lib/net/server/ServerUDP.java", "Java", 95, 0, 0, 79, 58, 232
"/Users/Joseph/Desktop/GitHub/Distributed-Automation-2/DA2/src/com/jtelaa/da2/lib/user/README.md", "Markdown", 0, 0, 0, 0, 1, 1
"/Users/Joseph/Desktop/GitHub/Distributed-Automation-2/DA2/src/com/jtelaa/da2/lib/user/ldap/LDAP.java", "Java", 47, 0, 0, 19, 25, 91
"/Users/Joseph/Desktop/GitHub/Distributed-Automation-2/DA2/src/com/jtelaa/da2/lib/user/local/Login.java", "Java", 3, 0, 0, 2, 4, 9
"/Users/Joseph/Desktop/GitHub/Distributed-Automation-2/DA2/src/com/jtelaa/da2/lib/user/local/User.java", "Java", 32, 0, 0, 3, 17, 52
"/Users/Joseph/Desktop/GitHub/Distributed-Automation-2/DA2/src/com/jtelaa/da2/lib/user/local/UserHandler.java", "Java", 40, 0, 0, 42, 28, 110
"/Users/Joseph/Desktop/GitHub/Distributed-Automation-2/DA2/src/com/jtelaa/da2/scheduler/Main.java", "Java", 23, 0, 0, 12, 12, 47
"/Users/Joseph/Desktop/GitHub/Distributed-Automation-2/DA2/src/com/jtelaa/da2/scheduler/README.md", "Markdown", 0, 0, 0, 0, 1, 1
"/Users/Joseph/Desktop/GitHub/Distributed-Automation-2/DA2/src/com/jtelaa/da2/scheduler/config.properties", "Properties", 0, 0, 0, 0, 1, 1
"Total", "-", 4118, 16, 26, 3058, 2538, 9756